111111111111111111111111111111111111111111111111111111111111
1P0000000111111000000000000000000000000000000000000000000001
100000000000000111111000000000000000000000000000000000000001
100000000000000000000111111000000000000000000000000000000001
100000000000000000000000000111111000000000000000000000000001
100000000000000000000000000000000111111000000000000000000001
100000000000000000000010001111110000000111111000000000000001
100000000000001110000000010001110000000000000111111000000001
100000000000001111111000000000000000000000000000000111111001
100000000000000000000000000000000000C00000000000000001111111
100000000000000001111110000000000000000000000000000000000001
100000000000000000000001111110000000000000000000000000000001
100000000000000000000000000001111110000000000000000000000001
100000000000000000000000000000000001111110000000000000000001
100000000000000000000000000000000000000001111110000000000001
100000000000000000000000000001111110000000000000000000000001
100000000000000000000000000000000001111110000000000000000001
100011111111111110000000000000000000000001111110000000000001
100000000000000000000000000000000000000000000001111110000001
100111111110000000011000000000010000000000000000000000000001
100000000000000000000000000000000000000000000000000001111111
100000000000000000000001000000000000000000000000000000000001
100000000000000011111000000000000000000000011111100000000001
101111111000000000000000000110000000011111100000000000000001
100000000000000000000000000000011111100000000000000000000001
101100000000000000000000011111111111100000000000000000000001
100000000000000000011111100000000000000000000000000000000001
100000000000011111100000000000000000000000000000000000000001
100000000000011111100000000000000000000000000000000000000001
1000000111111000000000000000000000000000E0000000000000000001
111111111111111111111111111111111111111111111111111111111111