11111111111111111111111111111
1P0000110000000111111000000C1
1C000000000C00001100000000001
100000000011100000E0000011111
10000000C00C00111110000001111
100C00001110000000C0000000001
11111111111111111111111111111