1111111111111
10010000001C1
100P011000001
100011E100001
1111111111111
