11111111111111
1C0000000000E1
10000000P00001
11011100001111
1E000000001111
11111111111111
