1111111111111111111111111111111111111
1P00000000000000000000111111111111111
100000C111110000000000000000111111111
1000000000000000000000000000000000001
1000000000000000000000000000000000001
1000000000000000000000000000000000001
1000000000000000000000000000000000001
100000000000000000000000C000000000001
1000000000000000000000000000000000001
1000000000000000000000000000000000000
1000000000000000000000000000000000001
1000000000000000000000000000000000001
1000000000000000000000000000000000001
1000000000000000000000000000000000001
1000000000000000000C00000000000000001
1000000000001111111100000000000000001
1000000000000000000000000000000000001
1000000000000000000000000000000000001
1000000000000000000000000000000000001
1000000000000000000000000000000000001
1000000000000000000000000000000000001
1000000C00000000000000000000000000001
1000000000000000000000000000000000001
1000000000000000000000000000000000001
1000000000000000000000000000000000001
1000000000000000000000000000000000001
10000000111111111100000000000C00000E1
1111111111111111111111111111111111111