11111111111111111111111
10000000000001000000001
10000000000000000000001
11011100001111000000001
10000000001111000000001
11111111000111000000001
10000000000001000000001
100000000000010000000E1
11011100001111000000111
100000000000000000000P1
11111111111111111111111
